#########################
#...........#...........#
#...#...............#...#
#.######.........######.#
 .#    #.### ###.#    #. 
 .#    #.#     #.#    #. 
#.######.#######.######.#
#....#.............#....#
#...........#...........#
#########################