##################
#                #
#   #        #   #
#  #          #  #
#    ###  ###    #
     #      #  
#    ########    #
#  #          #  #
#   #        #   #
#                #
##################