#########################
#                       #
# .                   . #
#                       #
         ### ###         
         #     #         
#        #######        #
# .                   . #
#                       #
#########################