#########################
#                       #
# .                   . #
#                       #
         ### ###         
#        #     #        #
# .      #######      . #
#                       #
#########################