#########################
#                       #
#   #              #    #
#                       #
                         
#                       #
#   #               #   #
#                       #
#########################