#########################
#                       #
#  #                 #  #
#                       #
                        
                         
#                       #
#  #                 #  #
#                       #
#########################