#########################
#                       #
#   #              #.   #
#   .                   #
         ### ###         
#   .    #     #        #
#   #    #######   .#   #
#                       #
#########################